		
Вид	Реквизит	Описание
*	ПометкаУдаления	Пометка удаления
	Владелец	Владелец
	Родитель	Группа
Контрагенты	ОсновнойДоговорКонтрагента.ПроцентКомиссионногоВознаграждения	% комиссионного вознаграждения <Осн. договор>
	ОсновнойДоговорКонтрагента.СпособРасчетаКомиссионногоВознаграждения	Способ расчета комиссионного вознаграждения <Осн. договор>
	ОсновнойДоговорКонтрагента.КонтролироватьДенежныеСредстваКомитента	Признак контроля суммы задолженности <Осн. договор>
	ОсновнойДоговорКонтрагента.ДопустимаяСуммаЗадолженности	Допустимая сумма задолженности <Осн. договор>
	ОсновнойДоговорКонтрагента.ВидВзаиморасчетов	Вид взаиморасчетов <Осн. договор>
	ОсновнойДоговорКонтрагента.ТипЦен	Тип цен номенклатуры <Осн. договор>
	ОсновнойМенеджерПокупателя	Основной менеджер покупателя
	ГруппаДоступаККонтрагенту	Группа доступа к контрагенту
Номенклатура	СтавкаНДС	Ставка НДС
	ОтветственныйМенеджерЗаПокупки	Ответственный менеджер за закупки
	ОсновнойПоставщик	Основной поставщик
	СтранаПроисхождения	Страна происхождения
	НомерГТД	Номер ГТД
*	Комментарий	Комментарий
	Описание	Описание
	Подразделение	Подразделение
	Ответственный	Ответственный
	НоменклатурнаяГруппа	Номенклатурная группа
	ЦеноваяГруппа	Ценовая группа
	ГруппаДоступности	Группа доступности
		
*	Дата	Дата
	Проведен	Проведение документа
	ПометкаУдаления	Пометка на удаление
	ОтражатьВУправленческомУчете	Признак принадлежности к упр. учету
	ОтраженоВОперУчете	Признак принадлежности к опер. учету
	ОтражатьВБухгалтерскомУчете	Признак принадлежности к бух. учету
	ОтражатьВНалоговомУчете	Признак принадлежности к налог. учету
	Подразделение	Подразделение
	Ответственный	Ответственный
	Комментарий	Комментарий